W W W W W W W W W W...
W W W W W W W W W W...
W W W W W W W W W W...
W G G G W W G G G W...
W G G G G G G G G W...
W G G G G G G G G W...
W G G G G G G G G W...
W G G G G G G G G W...
W G G G G G G G G W...
W W W W E,0,692,1 E,0,692,1 W W W W